Columns: 28
Rows: 31
3444444444444554444444444443
4111111111111771111111111114
4167761677761771677761677614
4267761677761771677761677624
4111111111111661111111111114
4000001000001111000001000004
4000001000000000000001000004
4000001000000000000001000004
4000001000000000000001000004
4000001000000000000001000004
4000001000000000000001000004
4000001000000000000001000004
4000001000000000000001000004
4000001000000000000001000004
4000001000000000000001000004
4000001000000000000001000004
4000001000000000000001000004
4000001000000000000001000004
4000001000000000000001000004
4000001000000000000001000004
4111111111111001111111111114
4167761677761001677761677614
4167671677761001677761767614
4211771111111111111111771124
4061771661677777761661771604
4061661771677667761771661604
4111111771111771111771111114
4167777667761771677667777614
4167777777761661677777777614
4111111111111111111111111114
3444444444444444444444444443
