Columns: 30
Rows: 33
000000000000000000000000000000
034444444444445544444444444430
041111111111117711111111111140
041677616777617716777616776140
042700717000717717000717007240
041677616777616616777616776140
041111111111111111111111111140
041677616616777777616616776140
041677617716776677617716776140
041111117711117711117711111140
034444617677607706776716444430
000000417677606606776714000000
000000417700000000007714000000
000000417706489984607714000000
344444616604000000406616444443
400000010004000000400010000004
344444616604000000406616444443
000000417706444444607714000000
000000417700000000007714000000
000000417706777777607714000000
034444616606776677606616444430
041111111111117711111111111140
041677616777617716777616776140
041676716777616616777617676140
042117711111110011111117711240
057617716616777777616617716750
057616617716776677617716616750
041111117711117711117711111140
041677776677617716776677776140
041677777777616616777777776140
041111111111111111111111111140
034444444444444444444444444430
000000000000000000000000000000
