Columns: 28
Rows: 31
3444444444444554444444444443
4111111111111771111111111114
4167761677761771677761677614
4270071700071771700071700724
4167761677761661677761677614
4111111111111111111111111114
4167761661677777761661677614
4167761771677667761771677614
4111111771111771111771111114
3444461767760770677671644443
0000041767760660677671400000
0000041770000000000771400000
0000041770648998460771400000
4444461660400000040661644444
0000001000400000040001000000
4444461660400000040661644444
0000041770644444460771400000
0000041770000000000771400000
0000041770677777760771400000
3444461660677667760661644443
4111111111111771111111111114
4167761677761771677761677614
4167671677761661677761767614
4211771111111001111111771124
5761771661677777761661771675
5761661771677667761771661675
4111111771111771111771111114
4167777667761771677667777614
4167777777761661677777777614
4111111111111111111111111114
3444444444444444444444444443
