Columns: 32
Rows: 31
00344444444444455444444444444300
00411111111111177111111111111400
00416776167776177167776167761400
00427007170007177170007170072400
00416776167776166167776167761400
00411111111111111111111111111400
00416776166167777776166167761400
00416776177167766776177167761400
00411111177111177111177111111400
00344446176776077067767164444300
00000004176776066067767140000000
00000004177000000000077140000000
00000004177064899846077140000000
34444446166040000004066164444443
40000000100040000004000100000004
34444446166040000004066164444443
00000004177064444446077140000000
00000004177000000000077140000000
00000004177067777776077140000000
00344446166067766776066164444300
00411111111111177111111111111400
00416776167776177167776167761400
00416767167776166167776176761400
00421177111111100111111177112400
00576177166167777776166177167500
00576166177167766776177166167500
00411111177111177111177111111400
00416777766776177167766777761400
00416777777776166167777777761400
00411111111111111111111111111400
00344444444444444444444444444300