Columns: 32
Rows: 31
33344444444444455444444444444333
44411111111111177111111111111444
44416776167776177167776167761444
44427007170007177170007170072444
44416776167776166167776167761444
44411111111111111111111111111444
44416776166167777776166167761444
44416776177167766776177167761444
44411111177111177111177111111444
44344446176776077067767164444344
44000004176776066067767140000044
44000004177000000000077140000044
33000004177064899846077140000033
34444446166040000004066164444443
40000000100040000004000100000004
34444446166040000004066164444443
33000004177064444446077140000033
44000004177000000000077140000044
44000004177067777776077140000044
44344446166067766776066164444344
44411111111111177111111111111444
44416776167776177167776167761444
44416767167776166167776176761444
44421177111111100111111177112444
44576177166167777776166177167544
44576166177167766776177166167544
44411111177111177111177111111444
44416777766776177167766777761444
44416777777776166167777777761444
44411111111111111111111111111444
33344444444444444444444444444333
